 3  4  2  0  2
 5  6  3  4  6
 1  4  1  0  3
 3  5  2  5  6
 0  4  6  3  1
