 0  2  0  2  1
 3  5  6  4  6
 1  4  0  3  1
 2  3  1  5  2
 4  6  2  4  6
